##########
#....T...#
#.#..#.#.#
#.#..#.###
#.####.#.#
#.T......#
#.....T..#
#...##.###
#.##.#.###
#..T.....#
##########