##########
#..T...T.#
#.####.#.#
#.#..#.#.#
#.#..#.#.#
#..T.....#
#.#..#.#.#
#.#..#.#.#
#.#..#.#.#
#.T......#
##########
